111111111111111111111111111111111
111111111111111111111111111111111
111111111111111111111111111111111
111111111111111011111111111111111
111111111100000000000111111111111
111111110000000000000001111111111
111111100000000000000000111111111
111111000000000000000000011111111
111110000000000000000000001111111
111100000000000000000000000111111
111000000000000000000000000011111
111000000000000000000000000011111
110000000000000000000000000001111
110000000000000000000000000001111
110000000000000000000000000001111
110000000000000000000000000001111
110000000000001110000000000001111
100000000000001S10000000000000111
110000000000000000000000000001111
110000000000000000000000000001111
110000000000000000000000000001111
110000000000000000000000000001111
110000000000000000000000000001111
111000000000000000000000000011111
111000000000000000000000000011111
111100000000000000000000000111111
111110000000000000000000001111111
111111000000000000000000011111111
111111100000000000000000111111111
111111110000000000000001111111111
111111111100000000000111111111111
111111111111111011111111111111111
111111111111111111111111111111111
111111111111111111111111111111111
111111111111111111111111111111111