NO texture/wall.xpm
SO texture/wall3.xpm
WE texture/wall4.xpm
EA texture/wall5.xpm
F 24,24,24
C 00,35,225

11111111111
11000000001
1010000S001
10010000001
10001000001
10001111121
10000000001
11111111111
