NO texture/wall.xpm
SO texture/wall3.xpm
WE texture/wall4.xpm
EA texture/wall5.xpm
F 88,75,72
C 227,214,211

1111111111111111111111111111111111111111
1000011000000101010000001000000010000001
10000000N0000101010000001000000010000001
1000011111110101010000001000000010000001
1000000000000101010000001000000010000001
1001111111000101010000001000000010000001
1000111001001101010000001000000010000001
1010000100001101010000001000000010000001
1001000000101101010000001000000010000001
1001010001001101010000001000000010000001
1001001111110101000000100000001000000111
1001001000000101010000001000000010000001
1001001000000101010000001000000010000001
1001000100000000000000001000000010000001
1001011111111111111111111000000010000001
1001000000000000000000001000000010000001
1001000000000000000000001000000010000001
10010000000111111111100001000000010000001
1001000000000000000000001000000010000001
10010000000000000001001000000010000001111
1001000000000000000000001000000010000001
1001000000000000000000001000000010000001
1111111111111111111111111111111111111111
