NO texture/wall.xpm
SO texture/wall3.xpm
WE texture/wall4.xpm
EA texture/wall5.xpm
F 42, 42, 42
C 12, 48, 128

            1111111111111111111111111
1111111111111000000000001
1011000001011000000000001
100100000011100000000000111111111
111111111011000001110000000000001
100000000011000001110111111111111
11110111111111011100000010001
11110111111111011101010010001
11000001111111011100N00010001
10000001    1000001100000010011
1000000111111000001101010010001
1100000000010101111101111010111
1111011111110101 10111101000001
11111111 1111111 1111111111111
11111111 1111111 1111111111111
11111111 1111111 1111111111111
