NO texture/squidgame.xpm
SO texture/squidgame.xpm
WE texture/squidgame.xpm
EA texture/squidgame.xpm
F 612,000,0
C 100,30,0

11111111111
10000000001
1000000S101
10001101001
10001100001
10000000001
10000000001
11111111111
